7 12 4
XXXXXXX
X..XXXX
X..XXXX
XGGGXXX
X.G...X
XM.X..X
XXX...X
X..J.XX
X..JJ.X
X..J..X
XXXX..X
XXXXXXX
