10 6 3
 XXXXXXXXX
 XM.J...GX
 X.....JXX
XG...J..X
XXXXXXXGX
      XXX
