08 09 02
 XXXXX
 X...XX
XX.XX.XX
XGJM.JGX
X...X..X
XXX...XX
  X.X.X
  X...X
  XXXXX

