08 09 02
 XXXXX
 X...XX
XX.XJ.XX
X.J....X
XG.GX..X
XXX.M.XX
  X.X.X
  X...X
  XXXXX

